[W W W W W W W W W W W W W W W W W W W W W W W W W W W W W]
[W W W W W W W W W W W W W X X X W W W W W W W W W W W W W]
[W W W W W W W W W W X X X X S X X X X W W W W W W W W W W]
[W W W W W W W W X X X X X E X E X X X X X W W W W W W W W]
[W W W W W W W X X X X X X X X X X H X B X X W W W W W W W]
[W W W W W W W X X X X X X X X X X X X X X X W W W W W W W]
[W X W W W X X X X X X X W W W W W X X X X X X X W W W X W]
[W X X X X X X B X X X X W W W W W X X X X B X X X X X X W]
[W 1 X E X H X X X X S X W W W W W X S X X X X H X E X 2 W]
[W X X X X X X B X X X X W W W W W X X X X B X X X X X X W]
[W X W W W X X X X X X X W W W W W X X X X X X X W W W X W]
[W W W W W W W X X X X X X X X X X X X X X X W W W W W W W]
[W W W W W W W X X B X H X X X X X X X X X X W W W W W W W]
[W W W W W W W W X X X X X E X E X X X X X W W W W W W W W]
[W W W W W W W W W W X X X X S X X X X W W W W W W W W W W]
[W W W W W W W W W W W W W X X X W W W W W W W W W W W W W]
[W W W W W W W W W W W W W W W W W W W W W W W W W W W W W]