[W W W W W W W W W W W W W W W W W W W W W W W W W W W W W]
[W W W W W W W W X X X X X X W W W W W W X X X X W W W W W]
[W W W W W W W X X X B X X X W W W W W W X E X X W W W W W]
[W W W W W W W X X W X W X X W W W W W W X X X X W W W W W]
[W X X X X X X X X X X X S X W W W W W W X X W X W W W W W]
[W X X X X E X X X B X X X X X X X X X X X X X X W W W W W]
[W W W W X X X X X X X X E X X H X X X X X X B X W W W W W]
[W W W W W W X H W W X X X X W W W X E X W X X X W W W W W]
[W W W W W W X X X W X X X X W W W X X X X X X X W W W W W]
[W W W W W W X E X X X X X X W W W X X W W X X X W W W W W]
[W W W W W W X X X X S X X X W W W X X B X S E X X X X X W]
[W W W W W W W W W W X X W X X X X H X X X X X X X X X X W]
[W W W W W W W W W W X X W X X X B X W W W W W W W X H X W]
[W W W W W W W W W W X B X X W X X X W W W W W W W X X X W]
[W W W W W W W W W W X X X X X X X X W W W W W W W 1 X 2 W]
[W W W W W W W W W W W W W W W W W W W W W W W W W W W W W]
[W W W W W W W W W W W W W W W W W W W W W W W W W W W W W]
