[W W W W W W W W W W W W W W W W W W W W W W W W W W W W W]
[W W W W W W W W W W W W W W W W W W W W W W W W W W W W W]
[W W W W W W W W W W X X X X X X X X X W W W W W W W W W W]
[W W W W W W W W W W X E X X X X X X X W W W W W W W W W W]
[W W W W W W W W W X X X X X X E X X X X W W W W W W W W W]
[W W W W W W W W X X S X X X X X X X X X X W W W W W W W W]
[W W W X X X X X X X X X B X X X X X E X X H X X X X W W W]
[W W W X X X H X X X X X X X W X X X X X X X X B X X W W W]
[W W W X X X X X X X H X X W W W X X X X X H B X B X W W W]
[W W W X X X H X X X X X X X W X X X X X X X X B X X W W W]
[W W W X X X X X X X X X B X X X X X E X X H X X X X W W W]
[W W W W W W W W X X S X X X X X X X X X X W W W W W W W W]
[W W W W W W W W W X X X X X X E X X X X W W W W W W W W W]
[W W W W W W W W W W X E X X X X X X X W W W W W W W W W W]
[W W W W W W W W W W X X X X X X X X X W W W W W W W W W W]
[W W W W W W W W W W W W W W W W W W W W W W W W W W W W W]
[W W W W W W W W W W W W W W W W W W W W W W W W W W W W W]